"a" = (/turf/closed/wall/mineral/titanium,/area/space)
"b" = (/obj/machinery/door/airlock/shuttle/glass,/turf/open/floor/iron/shuttle/arrivals{icon_state = "sign_2"},/area/space)
"e" = (/obj/structure/window/reinforced/spawner/directional/east,/obj/structure/chair/comfy/shuttle{dir = 8},/turf/open/floor/iron/white/side,/area/space)
"f" = (/turf/closed/wall/r_wall/plastitanium,/area/space)
"g" = (/turf/open/floor/iron/shuttle/arrivals{icon_state = "sign_3"},/area/space)
"i" = (/obj/machinery/computer/shuttle/arrivals{dir = 4},/turf/open/floor/iron/shuttle/arrivals,/area/space)
"l" = (/obj/machinery/door/airlock/shuttle/glass,/turf/open/floor/iron/shuttle/arrivals{icon_state = "sign_2"; dir = 1},/area/space)
"m" = (/turf/open/floor/iron/white/side{dir = 1},/area/space)
"n" = (/turf/template_noop,/area/space)
"r" = (/turf/open/floor/iron/shuttle/arrivals,/area/space)
"s" = (/obj/structure/chair/comfy/shuttle{dir = 8},/turf/open/floor/iron/white/side{dir = 1},/area/space)
"t" = (/turf/open/floor/iron/shuttle/arrivals{icon_state = "sign_1"},/area/space)
"u" = (/turf/open/floor/iron/white/side,/area/space)
"w" = (/obj/machinery/power/shuttle_engine/propulsion{dir = 4},/obj/docking_port/mobile/arrivals,/turf/open/floor/plating/airless,/area/space)
"A" = (/obj/machinery/power/shuttle_engine/heater{dir = 4},/obj/structure/window/reinforced/survival_pod/indestructible/spawner/directional/west,/turf/open/floor/plating/airless,/area/space)
"B" = (/obj/machinery/power/shuttle_engine/propulsion{dir = 4},/turf/open/floor/plating/airless,/area/space)
"D" = (/turf/open/floor/iron,/area/space)
"E" = (/turf/closed/wall/mineral/titanium/interior,/area/space)
"F" = (/obj/structure/window/reinforced/spawner/directional/east,/obj/structure/chair/comfy/shuttle{dir = 8},/turf/open/floor/iron/white/side{dir = 1},/area/space)
"G" = (/obj/structure/window/reinforced/spawner/directional/west,/turf/open/floor/iron/white/side,/area/space)
"H" = (/obj/structure/window/reinforced/spawner/directional/east,/obj/structure/chair/comfy/shuttle{dir = 8},/turf/open/floor/iron,/area/space)
"I" = (/obj/structure/chair/comfy/shuttle{dir = 8},/turf/open/floor/iron,/area/space)
"J" = (/turf/closed/wall/mineral/titanium/nodiagonal,/area/space)
"L" = (/obj/structure/chair/comfy/shuttle{dir = 8},/turf/open/floor/iron/white/side,/area/space)
"M" = (/obj/structure/window/reinforced/spawner/directional/west,/turf/open/floor/iron,/area/space)
"O" = (/turf/open/floor/iron/white,/area/space)
"P" = (/obj/effect/spawner/structure/window/reinforced/shuttle/indestructible,/turf/open/floor/iron/large,/area/space)
"T" = (/turf/closed/wall/r_wall/plastitanium/nodiagonal,/area/space)
"Z" = (/obj/structure/window/reinforced/spawner/directional/west,/turf/open/floor/iron/white/side{dir = 1},/area/space)

(1,1,1) = {"
naJJlJJPPJJlJJfn
aJEgtMIDIDHtgETT
PrrrrGLuLuerrrAB
PirrrOOOOOOrrrAw
PrrrrZsmsmFrrrAB
aJEgtMIDIDHtgETT
naJJbJJPPJJbJJfn
"}
